x0y00000000000000y00000y00x
x00000y00000y0000000000000x
x0000xxxx0000000y0e0y00000x
x00xx00000y00000xxxxx00000x
x00y0000000000x000000y000yx
x000000000000000000000000xx
xx000000y00y00000000000000x
x0000000x0xxx0000000y0y000x
xy00y0y0000000000000x0x00yx
xxx0x0x000000000y000000000x
x000000000000000xxx0000y00x
x0000000000y00000000000000x
x0000000xxxxxxx00000000000x
x000xxx0x00000x0xxxxxx0xxxx
x00000000000y000000000000yx
xxx0000y000000000000y00000x
x0000e000000000000000000x0x
x000xxxxxxxxxxxxxxxxxxxxx0x
x000000y000000y0000000y000x
xxxxxxxxxxxxxxxxxxxxxxxxxxx