w20
h20
44444444444444444444
4..................4
4..................4
4..................4
4..................4
4..................4
4...411111111114...4
4.....122222222....4
4.....123333322....4
4.....123333322....4
4.....123333322....4
4.....122222222....4
4...411111111114...4
4..................4
4..................4
4..................4
4..................4
4..................4
4..................4
43333333333333333334